WWWWW
WEEWW
WEXEW
WEEWW
WWWWW

EEEEE
WWEWW
WXXEW
WWEWW
EEEEE